+---------------------+
|                     |
|                     |
|                     |
|                     |
|                     |
|           x  +-+  +-+
|              |      |
|              |      |
|              |      |
|              |      |
|              |      |
+--------------+      |
|                     |
|           +----+    |
|           |    |    |
|       +---+    |    |
|       |        |    |
|       +--------+    |
|                     |
+---------------------+